1111111111111111111111111111111111
1E0000000000000C00B00C000000000001
1110010100100010101001000000010101
1010010010101010001001000000010101
1P00000B0C00C0000000B00000000000C1
1111111111111111111111111111111111