11111111111111111111111111111111111111
10000000000000000000000000000000000C01
10E00000000001111111B11111111111111101
100000000011111111CB01111B001111111101
100000001111111PC00001010C001111111101
1000011111111C000000010000001111111C01
1001111111C0000000B0000001111111100001
10111111C000B0000000000111111100000001
101111CCCCCCC0CCCCCC0111111100000B0001
101111111111111111110111111100B0011101
10111111111111111111011111110001111101
10111111111111111111011111110111111101
10BC000000000111111100000000000B000001
10000000000C011111110110000C00000B0001
100000B0000C0111111101111111111111B001
10000000000C011111110000000C0000000001
11111111111111111111111111111111111111